1111111111111111111111111
10C0000001C10000001111111
1000000000010M00001111111
1000000M00000000001111011
1000000000000000001111111
1000C0000000000M001111111
1000000000C00000001111111
1000000000000000001111111
1000000000000101011111111
100P0000000001E1001111111
1000000000000101001111111
1111111111111111111111111
